NO ./assets/wood.xpm
SO ./assets/colorstone.xpm
WE ./assets/greystone.xpm
EA ./assets/redbrick.xpm

DO ./assets/door.xpm

SP_1 ./assets/one.xpm
SP_2 ./assets/two.xpm
SP_3 ./assets/three.xpm
SP_4 ./assets/four.xpm
SP_5 ./assets/five.xpm
SP_6 ./assets/six.xpm

F 80,188,223
C 203,194,176




        1111111111111111111111111
        1000000000110000000000001
        1011000001110000000O00001
        1001000000000000O00000N01
111111111011000001110000000000001
10000000001100000111011111D111111
11110111111111011100000010001    
11110111111111011101010010001    
11000000110101011100000010001    
10000000000000001100000010001    
10000000000000001101010010001    
1100001111010101111101111000111  
11110111 1110101 101111010001    
11111111 1111111 111111111111    