NO ./assets/wood.xpm
SO ./assets/colorstone.xpm
WE ./assets/greystone.xpm
EA ./assets/redbrick.xpm

F 80,188,223
C 203,194,176

        1111111111111111111111111
        1000000000110000000000001
        10110000011100000000000011111111
        1001010100000000000000N01
111111111011001001110000000000001
100000000011000001110111110111111
11110111111111011100000010001    
11110111111111011101010010001    
11000000110101011100000010001    
10000000000000001100000010001    
10000000000000001101010010001    
1100001111010101111101111000111111111111111111111
11110111 1110101 101111010001    
11111111 1111111 111111111111    